111111111111111
100000010000001
101111010111101
101100000001101
101101111101101
100000000000201
101111101111101
100000000000001
101111111111101
100000000000001
111101111101111
100000200000001
101111101111101
100000000000001
111111111111111